00000000
00011111
00000000
66600000
00000000
00000444
00000000
00000000
33333333
